# # # # # # # # # # # # # # # # # # # # #
# . . . # . . . . . C . . . # . . . . . #
# . # . # . # # . . # # # # # . # # # . #
# . # . # . # R # . J E . . . M # . . . #
# . # . # . . . # . # # . # # # # . . # #
# . # . . . . . . . . . . . . . # . . . #
# . # # . # . # . # . # . # . # # N # . #
# . . . . . . . . . . . . . B . . . # . #
# . . . # # # # . # # # . I # # # . . . #
# . # . . . . . L H # . . . . . # . # T #
# # # . # . # # # . # . # # # . # . . S #
# . . . # . # . # . # . . . # . . . # . #
# . . # . . . . # . . # . G . # . # # . #
# . . . # P . . # . Q . # D . . . . . . #
# . # . # # O # # . # . . # # # # # . . #
# K # . . . . . # . # . . . . . . . # . #
# # . # # . # . # # # # # . # # # # # . #
# . . . # . # . # . . . . . F . . . . . #
# . # . . # # . . . # . # # # . . # # # #
# s # . . . . . # . . A . . . . . . . . #
# # # # # # # # # # # # # # # # # # # # #
