# # # # # # # # # # # # # # # # # # # # #
# . T . . . . . . . . . . . . . # R P . #
# . # # # # # # # # . . # # # . # # # . #
# . # . . . . . . . . . A . # . # . . . #
# . . . # # # # . # # # # . . . # . . # #
# . . . . O . . # . . . . . . S # . . . #
# . . # # # # . # # . # . H # # # . . . #
# . . . # . . . . . . . # . # . . M . . #
# # # . # K . # # . . B # . # . . . . . #
# . # . # . . . # . # . # . . . # . . . #
# . Q . # # C . . . # . # # # . . . # . #
# . # . . D # . . . # . . . # . . . . . #
# . # . L . # . . . # # # . . . # # # . #
# . . . # I . . . N . . # . . . # F . . #
# . . . . # # . # # # . # . # . . # # J #
# . . . E . . . . . . . G . # . . . # . #
# # # # # . # # . . # . # # # # # . # . #
# . . . . . # . . . . . . . # . . . # . #
# . # # # . # . # # . # # . # . # # . . #
# s # . . . . . # . . . . . . . # . . . #
# # # # # # # # # # # # # # # # # # # # #
