# # # # # # # # # # # # # # # # # # # # #
# . . . . C # . . . . . . . . . . . # . #
# . # . D . . . . # . # # . # # # . # H #
# M # . # . # . # . . E . . # . . . # . #
# # # . . . # # . . # # # # . . # . . . #
# . F . # . . . # . # B K . . . # . . . #
# . . . . # # . # . # . # . # # . # # . #
# . . . # R # G . . # . # . . . . . . . #
# . . . # . # # # # # . # A # # # # # # #
# . # . # . # . . . # . . . # N . S . . #
# . . . # . # . # . # # # . . . . . # . #
# . . . . . # . # . . . . . # J . . . . #
# # . . # . # . # . . P # # # . # . . # #
# . . O . . . . . . . . # . . . . . . . #
# . # # # . # # # . # # . # # . . # # . #
# . # . . . # . . . . . . . . . . . # . #
# . # # . . # # # . # # # # # # . . . . #
# . . . # . . . L . # . . . . . # . . . #
# . # . # # . # . # . . # # # # . . . # #
# s . . # I . . T . . . . . . Q . . . . #
# # # # # # # # # # # # # # # # # # # # #
