# # # # # # # # # # # # # # # # # # # # #
# . # . . . T . . . . . . . . . # . . . #
# . . . # P # # # . # # # . . H . . # . #
# . # . # . # . . . . S . . # . . . # . #
# . # . . . . . . # . # # # # . # # # . #
# . # . # . . . # . . . E . # . . . . . #
# . Q . . # # # # . # . # . # R # . . # #
# . . . # . K . . . # . # . # . # . . . #
# . # # . . # # # . . A . . # . # . # . #
# . # . . . . . # . . . # . . . # . . . #
# . . # # # . . # . # # # # # . # . # # #
# D . . . . # . # I . . # . # . # M . . #
# . # # . O # . # . . . . . . L # # # B #
# . . . . . . . . . . . # . # . . . . . #
# # # . . . # # . # # . # . . . # # . # #
# . . . . . . . # . . . # . . . J . . . #
# . # # # # # . . . # . # # # . # F # . #
# . . . . . # N . . . . . . . . . . # . #
# # . . # . # . # # . # # # # # # # # . #
# s C . . . # . . . . . . . . . G . . . #
# # # # # # # # # # # # # # # # # # # # #
