# # # # # # # # # # # # # # # # # # # # #
# . . . . . . E . . . . . . # H # . . . #
# # # . # # # # # # # # . . # . # . # . #
# . . . . . . . . . . . # . # . . . # . #
# . # # # L # . # # # # # . # # . . # . #
# . # . . . . . . . # . . . # . D . . . #
# . # . . # . # # . # . # # # . # # # # #
# . . . . . . . . . . . # C . N . . . . #
# S # . . . # # # # # . # . # # . # # . #
# . . . # . . . . . . . # . # . . . . . #
# . # # # . # . . # # # . . . . # . # # #
# . . . # . . . # . . . . . . . # . . . #
# . . . # # # . . # # # # # . . # # . . #
# . # . # . . . # . . . # . . . # . Q . #
# . . . . . . . # . . . R F . I # . . . #
# . # . G . # . . . # J # . # . . . # . #
# . # # # . # # # # # . # . # # # # # P #
# . O . # . A . # . # . . . # . . . . . #
# # # # # # # . . M . . # . . . K # # # #
# s . . . . . . # . . . . . # . B . . . #
# # # # # # # # # # # # # # # # # # # # #
