# # # # # # # # # # # # # # # # # # # # #
# . . . . S . . . . . . . . . . . . . . #
# . . . . . # # # # # . # . . # # # # . #
# . # . . . # . O . # . . B # A M . # . #
# H # # # . # R # . # K # # # # # . . . #
# J # . . . C . # . . . . . . . # . . . #
# # # . # # . . . # # # # # # . # . . # #
# . . E # . . G # . . . . . # . # . . . #
# . . # # . # # . T # # # . . . . . . . #
# . . . . . # . . . # . . . # . # . . . #
# . . # # # # . # # N . . # . . # . # # #
# . . . # . # . # . . . # . . . # . . . #
# # # . L . I . # # # . # . # # # # . . #
# . F . . . . . D . # . # . # . . . . . #
# # # # # # . . . . # . Q . # # . # # P #
# . . . . . # . # . # . # . . . . . # . #
# . # # # . # . # . # . # # . # # . # # #
# . # . # . # . # . # . . . . . # . . . #
# . # . # . # # # . # # # # . . # # . . #
# s # . . . . . . . # . . . . . . . . . #
# # # # # # # # # # # # # # # # # # # # #
