# # # # # # # # # # # # # # # # # # # # #
# . . . # . . . . C . . K . . . . . . . #
# # . . O N # # . # # . # # # . . . # . #
# . . . # . # F . . # . . . . . # . # . #
# . # # # . # # # . # # # # . # # . . . #
# . . A # . . . # . . . # . . . # . . S #
# # . . # # . . # . # # . . . . . . # # #
# . I . . . # . # . . . # . # . # . . . #
# . # # # . # . # . . . . H # . # . # . #
# . E . # . # . # . # . . G # . . . # . #
# # B Q # # . . # # . # # # # . # . . . #
# . . . # . . . . . . . . . # T # . # . #
# . # # # . . # # # # # L . . # . . # . #
# . . . . . . . # . . . # . . . . . # . #
# # # # # # # . # . # . # # # . . # # . #
# . . . # P . . # . # . . . # . . . . . #
# . # . # R # # . . # # # . . # # . # # #
# . # . # . . . # . . . # . . . # . . . #
# . . . # # . # # . . . . # # . # # # . #
# s # . . . J M . . . . # . . . . . . D #
# # # # # # # # # # # # # # # # # # # # #
