# # # # # # # # # # # # # # # # # # # # #
# . # . . . . . . . . . # . D . . . . . #
# . # . . # # . # . # . # . # # # # # . #
# . R . # . . . . . # B . . # . . . # . #
# Q # # . . # # # # # # # # . # # . # . #
# . # . . G # . . . . . . H # . . . # . #
# . . E # . # . . # . # # A . . . # # . #
# . # . . . . . # . . . . . . . # . . . #
# . . # # # # # # . # # . # . . # . # # #
# F # . . . N . . . # . . . # O . . . . #
# # J . # # # # . # . . # # . . # # # . #
# . . . # . . . # . # . K . # . # . . T #
# . . # . . # . . . # . . . . I # . # P #
# . . . # . # . . . # . # . # . . . # . #
# # # . # . . # # . . . # . . # # # . . #
# . . . # . . . # . . . # . . L . M # . #
# . . # . C . . . . # # # # # . . # # . #
# . # . # . # . . . # . . . # . . . . . #
# . # . . . . # # # # . # . . # # # # # #
# s # . . . . . . . S . # . . . . . . . #
# # # # # # # # # # # # # # # # # # # # #
