# # # # # # # # # # # # # # # # # # # # #
# I . . . . . . . . . . # J L . . . . . #
# . # # # # # . # # . . # K # # # . . # #
# . # . . . . . # . . . # . . . # . . . #
# # # . . # # # # . # . # # # . # # . . #
# A . . . . . . # . . . # . . . . . # . #
# . # # # . # # # # . . . # # # # . # . #
# . # P . . . . . . # . . . . . . . . . #
# . N # R # # # # . # # # # # # # # . S #
# . . . # . . . . . . . # . . . . . . . #
# . O . # . # # . # # # . . . # # # # # #
# . # . # . . . . Q . . . . # . . G T . #
# . . . # . . # # . # # . # # # # # # . #
# . # . # . . . # . # . . . . . . . . . #
# . # . # # . . . . # . # # # . . # E . #
# . # . # . . . . . . . . F # . # . . . #
# . # . . . . # # # # # # # . . # # . . #
# B # . . D . . . . C . . . # . . M # . #
# # . . # . . # # . # # . . # # # . # . #
# s . . # . . H . . # . . . . . . . # . #
# # # # # # # # # # # # # # # # # # # # #
