# # # # # # # # # # # # # # # # # # # # #
# M . . # . # . . . P . . . . S # . . . #
# . # . # . # . # . # # # # . . # . # . #
# . # . # . B . # . C . # D # . . . # . #
# . # . # # # # # # . . # . # # # . # Q #
# . # . . . . . . . . . # E . . . . . . #
# . . # # # . # # . # . # # . # # # . . #
# . . . K . . . # . # . . A . . . . I . #
# # # . # . . . # # . . # # . . # . # # #
# . . . . . # . . . . . # . . . # . . . #
# . # # # . # # . # . # # . # . . # # . #
# . . . . . # . . . . . . . # . . . # . #
# . . # # . . . # . # . # # . # # . # . #
# . # G . . . . # . T . . . . . # . # . #
# # # . # . # . . # # # . . # R # . . . #
# . . . . . . . # . . . . . # . # . # . #
# . # # # . . . . . # # # . # . # F . H #
# . # . # . # . . . N . . . . . # . . . #
# . . . # . # . # # # . # # . . # # # . #
# s # . . . . O . . . . # . . . . . . J #
# # # # # # # # # # # # # # # # # # # # #
