# # # # # # # # # # # # # # # # # # # # #
# . . . # . . . . . # . . . . . # . . E #
# . # . # . # # # . # . # . # . # . # . #
# . # . # . # . . . # . # . # . # . # . #
# . # # # . # . # # # . # . # . # . # . #
# . . . . . # . . . . . # . # . . . # . #
# . # # # # # # # # # # # . # # # # # . #
# . # . . . . . . . . . # . # . . . # . #
# . # # # # # . # # # # # . # . # . # . #
# . . . . . . . # . . . # . . . # . # . #
# # # # # # # . # . # . # # # . # . # # #
# . . . . . . . # . # . . . # . # . . . #
# . # # # # # . # . # # # . # . # # # . #
# . # . . . # . # . # . . . # . # . . . #
# # # . # . # # # . # . # # # # # . # . #
# . . . # . . . # . # . . . . . . . # . #
# . # # # # # . # . # # # # # # # # # . #
# . . . # . . . # . # . . . . . . . # . #
# # # . # . # # # . # . # # # # # # # . #
# S . . # . . . . . # . . . . . . . . . #
# # # # # # # # # # # # # # # # # # # # #
