# # # # # # # # # # # # # # # # # # # # #
# . . . . . # . . . # . . . . C . . . E #
# . # # # . # # # . # . # # # # # . # . #
# . . . # . . . # . . . # . . . . . # . #
# . # . # # # . # # # # # . # # # # # . #
# . # . # . # . . . # . . . # . . . # . #
# # # . # . # # # . # . # # # # # . # . #
# . . B # . . . . . # . . A . . # . . . #
# . # # # # # . # # # # # # # . # . # # #
# . . . . . # . . . . . . . . . # . # . #
# # # # # . # # # # # # # # # # # . # . #
# . . . . . # . . . # . . . . . # . . . #
# . # # # # # . # . # . # . # # # # # . #
# . # . . . . . # . # . # . # E . . . . #
# . # . # # # # # . # . # . # . # # # # #
# . # . # . . . . . . . # D # . # . . . #
# . # . # . # # # # # # # # # . # # # . #
# . # . # . # . . . . . . . # . # . . . #
# . # . # # # . # # # # # . # . # . # . #
# S # . . . . . . . . . # . . . . . # . #
# # # # # # # # # # # # # # # # # # # # #
