# # # # # # # # # # # # # # # # # # # # #
# . . . . . . . . . . . . . . . . . . . #
# . # # # # # # # # # # # # # # # . # . #
# . # . . . . . # . . . . . . . . . # . #
# . # . # # # . # . # # # # # # # # # . #
# . # . # . . . . . # . . . # . . . . . #
# . # . # . # # # # # A # . # # # # # # #
# . # D # . # . . . . . # . # . . . . . #
# # # . # C # . # # # # # . # . # # # . #
# . . . # . # . # . . . # . . . # . # . #
# . # # # # # . # . # # # # # . # . # . #
# . . . . . . . . . # . . . # . . . # . #
# . # # # # # # # # # . # . # # # . # . #
# . . . # . . . . . . . # . # . . . # . #
# # # . # . # # # # # # # . # # # # # . #
# . . . # . . . . . . . # . . . . . # . #
# . # # # # # # # # # . # # # # # . # . #
# . # . . . # . . . . . # B . . # . # . #
# # # . # . # . # # # # # . # # # . # . #
# s . . # . . . # . . . . . . . . . . . #
# # # # # # # # # # # # # # # # # # # # #
